R 960 600
NO ./pics/greystone.xpm
SO ./pics/redbrick.xpm
WE ./pics/wood.xpm
EA ./pics/colorstone.xpm

S ./pics/pillar.xpm
F 0,0,255
C 0,255,0

11111111111111111111
10000000000000000001
10000S00000000000001
10000000020000000001
10020000220000000001
10000000020000000001
10000000000000000001
10000000000000000001
10000000000000000001
10000000000000000001
10000000000000000001
10000000000000000001
10000000000000000001
10000000000000000001
10000000000000000001
10000000000000000001
10000000000000000001
10000000000000000001
11111111111111111111