R 960 600
NO ./pics/greystone.xpm
SO ./pics/redbrick.xpm
WE ./pics/wood.xpm
EA ./pics/colorstone.xpm

S ./pics/pillar.xpm
F 0,0,255
C 0,255,0

    11111
  1110001111
1110000010011111
1000E00110000001111
1000000000000000001  
1000200020011111111 
1110000002000000001
  11111100201111111
      1100011
       11000111111
        1100000001
         111111111