    11111
  1110001111
1110000010011111
1000000110000001111
1000000000000000001  
1000000000011111111 
1110000000000000001
  11111100001111111
      1100011
       11000111111
        1100000001
         111111111