    11111
  1110001111
1110000010011111
1000000110000001111
1000000000000000001  
1000000020011111111 
1110000002000000001
  11111100201111111
      1100011
       11000111111
        1100000001
         111111111