R 1280 800

NO ./pics/greystone.xpm
SO ./pics/redbrick.xpm
WE ./pics/wood.xpm
EA ./pics/colorstone.xpm
S ./pics/pillar.xpm
C ./pics/sky_moon.xpm
F  255,255,255,

        1111111111111111111111111
        1000000000110000000000001
        1011000001110000002000001
        1001000000000000000000001
111111111011000001110000000000001
100000000011000001110111110111111
11110111111111011100000010001
11110111111111011101010010001
11000000110101011100000010221
10002000000000001100000010001
10000000000000001101010010001
11000001110101011111011110N0111
11110111 1110101 100011000001
11111111 1111111 111111111111


